111111111111111
1P0000000010001
111011101111101
1C0010000000C01
101111111110111
101000000000001
101011101111101
100000000000E01
111111111111111