111111111111111111111111111111111111111111111111
1000000000000000000000100000000000000000000000P1
10000000000000000000C010000000000000000000000001
100000000000000000000010000000000000000000000001
10000000000000000000C010000000000000000000000001
1000000000000C0000000010000000000000000000000001
100000000000000000000010000000000000000000000001
100000000010011111110010000000000000000000000001
1000000001C1000000000000000000000000000000000001
100000000001000000000000000000000000000000000001
1000000000010000000000000000000000000000000000E1
111111111111111111111111111111111111111111111111