1111111
1111111
1111111
1111111
1111111
1111111
111ECP1
1111111